R 1920 1080

NO ./path_to_the_north_texture
SO ./path_to_the_south_texture
WE ./path_to_the_west_texture
EA ./path_to_the_east_texture
S ./path_to_the_sprite_texture
F 225,255,255
C 135,206,235
1111111111111111111111111
1000000000110000000000001
1011000001110000002000001
10010000000000000000000011111
11111111101100000111000000001   1111
10000000001100000111011111111   1001
11110111111111011100000010001   1111
11110111111111011101010000001
11000000110101011100000000001
11111111111111111111111110011
10002000000000001100000000001
10000000000000000001010000001
11000001110101011111011110N01
11110111 1110001 100000010001
11111111 1111111 111111111111