R 960 540

NO ./texture/111.xpm
SO ./texture/333.xpm
WE ./texture/222.xpm
EA ./texture/444.xpm
S ./texture/555.xpm
F 0,118,128
C 224,255,255
        1111111111111111111111111
        1000000000110000S00020001
        1011000001110000002000201
        1001000000002002000000001
111111111011000001110000202000001
100000000011000001110111111111111
11110111111111011100000010001
11110111111111011101010010001
11000000110101011100000000201
10002000000000001100000000001
10000000000000001101010010001
1100000111010101111101111000111
11110111 1110101 101111010001
11111111 1111111 111111111111