
R     1280    920

NO ./texture/111.xpm
SO ./texture/111.xpm
WE ./texture/111.xpm
EA ./texture/111.xpm
S ./texture/555.xpm


F 0, 118, 128
C 224, 255, 255

        1111111111111111111111111111111111111111
        1000000000110000000000000000000000000001
        1011000001110200002000000000000000000001
        1001000000000002000002001111111111111001
111111111011000001110000000000001           1001
100000000011000001110111110111111           1001
111101111111110111000000100011111111111111111001
100000000011110111010100100012020202020202021001
110000001101010111000000100010202020202020202001
100020000000000011000000000W00000000000000000001
100000000000000011010100100000000000000000000001
110000011101010111110111100010202020202020202001
11110111 1110101 1011110100012222222222222020111
11111111 1111111 11111111111111111111111111111
