R 960 540

NO ./texture/111.xpm
SO ./texture/333.xpm
WE ./texture/222.xpm
EA ./texture/444.xpm
S ./texture/555.xpm


F 0, 118, 128
C 224, 255, 255

         111111111111111111111111111
         100000000011000000000000111
         111011000001110200200020001
         10010000000000000100E0000011
111111111011000001110002000000001111
10000000001100000111011111111101111
1111011111111101110000001000110111
1111011111111101110101001000111111
11000000111101011100000010001
1000000001  10001100000010001
10000000001100001101010000001
11000001110101011111011110011
11110111 1110101 101111010001
11111111 1111111 111111111111