R 1920 1080

NO ./texture/1.xpm
SO ./texture/3.xpm
WE ./texture/2.xpm
EA ./texture/4.xpm
S ./texture/1.xpm
F 225,255,255
C 135,206,235
1111111111111111111111111
1000000000000000000000001
1011000000000000002000001
10010000000000000000000011111
11111111100000000000000000001   1111
10000000001100000000011111111   1001
11110111111111000000000010001   1111
11110111111111000000000000001
11000000110101000000100000001
11111100000000000011110000011
10002000000000000001100000001
10000000000000000000000000001
11000001110101011111110000S01 
11110111 1110001 100000010001
11111111 1111111 11111111111